..........................
..........................
..........................
..........................
..........................
G.........................
R.........................
RGG......GGGG..........GGG
RRRGGGGGGRRRRGGGGGGGGGGRRR
RRRRRRRRRRRRRRRRRRRRRRRRRR